WWWWWWWWWWWWWWWWWWWW
WVWWVWWVWWWWWWWWWWVW
WVWWVWWVWWWWWWWWWWVW
WVWWVWWVWWVVVVVVVVVW
WVWWVWWVWWVWWWWWWWVW
WVWWVWWVWWVWWWWWWWCW
WVWWBWWVWWVWWWWWWWVW
WVWWVWWVWWVWWWWWWWVW
WVWWVWWVWWVVVCVVVVVW
WVWWVWWVWWVWWWWWWWVW
WVVVVBVVVVVVVVVPVVVW
WWWWWWWWWWWWWWWWWWWW