WWWWWWWWWWWWWWWWWWWW
WVWWVWWVWWWWWWWWWWVW
WVWWVWWVWWWWWWWWWWVW
WVWWVWWVWWWWWWWWWWVW
WVWWVWWVWWWWWWWWWWVW
WVWWVWWVWWWWWWWWWWVW
WVWWVWWVWWWWWWWWWWVW
WVWWVWWVWWWWWWWWWWVW
WVWWVWWVWWVVVVVVVVVW
WVWWVWWVWWVWWWWWWWVW
WVVVVVVVVVVVVVVPVVVW
WWWWWWWWWWWWWWWWWWWW